ษออออออออออออออออออออออออออออออออออออออออออออออออป
บ                                                บ
ฬออออออออออออออออออออออออออออออออออออออออออออออออน
บ                                                บ
บ                                                บ
บ                                                บ
บ                                                บ
บ                                                บ
บ                                                บ
บ                                                บ
บ                                                บ
บ                                                บ
บ                                                บ
บ                                                บ
บ                                                บ
บ                                                บ
บ                                                บ
บ                                                บ
บ                                                บ
บ                                                บ
บ                                                บ
บ                                                บ
บ                                                บ
บ                                                บ
บ                                                บ
บ                                                บ
บ                                                บ
บ                                                บ
บ                                                บ
บ                                                บ
บ                                                บ
บ                                                บ
บ                                                บ
บ                                                บ
บ                                                บ
บ                                                บ
บ                                                บ
บ                                                บ
บ                                                บ
บ                                                บ
บ                                                บ
บ                                                บ
บ                                                บ
บ                                                บ
บ                                                บ
บ                                                บ
บ                                                บ
บ                                                บ
บ                                                บ
ศออออออออออออออออออออออออออออออออออออออออออออออออผ
