ษออออออออออป
บ          บ
ฬออออออออออน
บ          บ
บ          บ
บ          บ
บ          บ
บ          บ
บ          บ
บ          บ
บ          บ
ศออออออออออผ
